{
  "width": 9,
  "height": 7,
  "tileSize": 16,
  "layers": [
    {
      "name": "cave",
      "data": [
        78, 78, 78, 78, 78, 78, 78, 78, 78,
        78, 78, 78, 78, 78, 78, 78, 78, 78,
        78, 78, 10, 10, 10, 10, 10, 78, 78,
        78, 10, 10, 0, 0, 0, 10, 10, 78,
        78, 10, 0, 0, 0, 0, 0, 10, 78,
        78, 10, 0, 0, 57, 0, 0, 10, 78,
        78, 10, 10, 10, 10, 10, 10, 10, 78
      ]
    }
  ]
}