{
  "width": 9,
  "height": 7,
  "tileSize": 16,
  "layers": [
    {
      "name": "cemetery",
      "data": [
        5, 5, 5, 5, 5, 5, 5, 5, 5,
        5, 48, 0, 48, 0, 48, 0, 48, 5,
        5, 0, 0, 0, 0, 0, 0, 0, 5,
        5, 48, 0, 48, 0, 48, 0, 48, 5,
        5, 0, 0, 0, 0, 0, 0, 0, 5,
        5, 48, 0, 48, 0, 48, 0, 48, 5,
        5, 5, 5, 82, 82, 5, 5, 5, 5
      ]
    }
  ]
}