{
  "width": 7,
  "height": 7,
  "tileSize": 16,
  "layers": [
    {
      "name": "community_fountain",
      "data": [
        0, 0, 0, 0, 0, 0, 0,
        0, 5, 5, 5, 5, 5, 0,
        0, 5, 25, 26, 27, 5, 0,
        0, 5, 33, 13, 35, 5, 0,
        0, 5, 41, 42, 43, 5, 0,
        0, 5, 5, 5, 5, 5, 0,
        0, 0, 0, 0, 0, 0, 0
      ]
    }
  ]
}