{
  "width": 7,
  "height": 9,
  "tileSize": 16,
  "layers": [
    {
      "name": "dock",
      "data": [
        0, 0, 0, 0, 0, 0, 0,
        0, 0, 0, 0, 0, 0, 0,
        25, 26, 26, 26, 26, 26, 27,
        33, 13, 13, 13, 13, 13, 35,
        33, 13, 13, 13, 13, 13, 35,
        33, 13, 13, 87, 13, 13, 35,
        33, 13, 13, 87, 13, 13, 35,
        33, 13, 13, 87, 13, 13, 35,
        41, 42, 42, 42, 42, 42, 43
      ]
    }
  ]
}