{
  "width": 7,
  "height": 7,
  "tileSize": 16,
  "layers": [
    {
      "name": "dungeon",
      "data": [
        1, 1, 1, 1, 1, 1, 1,
        1, 1, 1, 1, 1, 1, 1,
        1, 1, 0, 0, 0, 1, 1,
        1, 1, 0, 0, 0, 1, 1,
        1, 1, 0, 0, 0, 1, 1,
        1, 1, 1, 57, 1, 1, 1,
        1, 1, 1, 1, 1, 1, 1
      ]
    }
  ]
}