{
  "width": 9,
  "height": 7,
  "tileSize": 16,
  "layers": [
    {
      "name": "dungeon_entrance",
      "data": [
        1, 1, 1, 1, 1, 1, 1, 1, 1,
        1, 1, 1, 1, 1, 1, 1, 1, 1,
        1, 1, 10, 10, 10, 10, 10, 1, 1,
        1, 10, 10, 10, 57, 10, 10, 10, 1,
        1, 10, 5, 5, 5, 5, 5, 10, 1,
        1, 10, 5, 5, 5, 5, 5, 10, 1,
        1, 1, 10, 10, 10, 10, 10, 1, 1
      ]
    }
  ]
}