{
  "width": 9,
  "height": 7,
  "tileSize": 16,
  "layers": [
    {
      "name": "farm_field",
      "data": [
        84, 81, 81, 81, 81, 81, 81, 81, 84,
        81, 64, 64, 64, 64, 64, 64, 64, 81,
        81, 64, 37, 37, 37, 37, 37, 64, 81,
        81, 64, 37, 37, 38, 37, 37, 64, 81,
        81, 64, 37, 37, 37, 37, 37, 64, 81,
        81, 64, 64, 64, 64, 64, 64, 64, 81,
        84, 81, 81, 81, 82, 81, 81, 81, 84
      ]
    }
  ]
}