{
  "width": 9,
  "height": 7,
  "tileSize": 16,
  "layers": [
    {
      "name": "flower_field",
      "data": [
        8, 8, 8, 8, 8, 8, 8, 8, 8,
        8, 8, 8, 8, 8, 8, 8, 8, 8,
        8, 8, 37, 8, 37, 8, 37, 8, 8,
        8, 37, 8, 38, 8, 38, 8, 37, 8,
        8, 8, 38, 8, 37, 8, 37, 8, 8,
        8, 37, 8, 37, 8, 38, 8, 37, 8,
        8, 8, 8, 8, 8, 8, 8, 8, 8
      ]
    }
  ]
}