{
  "width": 11,
  "height": 9,
  "tileSize": 16,
  "layers": [
    {
      "name": "forest_clearing",
      "data": [
        47, 0, 47, 0, 47, 0, 47, 0, 47, 0, 47,
        0, 47, 0, 47, 0, 47, 0, 47, 0, 47, 0,
        47, 0, 8, 8, 8, 8, 8, 8, 8, 0, 47,
        0, 47, 8, 8, 8, 8, 8, 8, 8, 47, 0,
        47, 0, 8, 8, 8, 8, 8, 8, 8, 0, 47,
        0, 47, 8, 8, 8, 8, 8, 8, 8, 47, 0,
        47, 0, 8, 8, 8, 8, 8, 8, 8, 0, 47,
        0, 47, 0, 47, 0, 47, 0, 47, 0, 47, 0,
        47, 0, 47, 0, 47, 0, 47, 0, 47, 0, 47
      ]
    }
  ]
}