{
  "width": 8,
  "height": 6,
  "tileSize": 16,
  "layers": [
    {
      "name": "garden",
      "data": [
        81, 81, 81, 81, 81, 81, 81, 81,
        81, 12, 12, 12, 12, 12, 12, 81,
        81, 12, 37, 12, 38, 12, 37, 81,
        81, 12, 12, 38, 12, 38, 12, 81,
        81, 12, 37, 12, 37, 12, 38, 81,
        81, 81, 81, 82, 82, 81, 81, 81
      ]
    }
  ]
}