{
  "width": 11,
  "height": 6,
  "tileSize": 16,
  "layers": [
    {
      "name": "island",
      "data": [
        25, 26, 26, 26, 26, 26, 26, 26, 26, 26, 27,
        33, 93, 93, 93, 93, 93, 93, 93, 93, 93, 35,
        33, 93, 93, 93, 93, 93, 93, 93, 93, 93, 35,
        33, 93, 93, 93, 93, 93, 93, 93, 93, 93, 35,
        33, 93, 93, 93, 93, 93, 93, 93, 93, 93, 35,
        41, 42, 42, 42, 42, 42, 42, 42, 42, 42, 43
      ]
    }
  ]
}