{
  "width": 9,
  "height": 7,
  "tileSize": 16,
  "layers": [
    {
      "name": "lava_pit",
      "data": [
        1, 1, 1, 1, 1, 1, 1, 1, 1,
        1, 1, 1, 66, 66, 66, 1, 1, 1,
        1, 1, 66, 66, 66, 66, 66, 1, 1,
        1, 66, 66, 66, 67, 66, 66, 66, 1,
        1, 1, 66, 66, 66, 66, 66, 1, 1,
        1, 1, 1, 66, 66, 66, 1, 1, 1,
        1, 1, 1, 1, 1, 1, 1, 1, 1
      ]
    }
  ]
}