{
  "width": 7,
  "height": 7,
  "tileSize": 16,
  "layers": [
    {
      "name": "magic_circle",
      "data": [
        0, 0, 76, 0, 76, 0, 0,
        0, 76, 5, 5, 5, 76, 0,
        76, 5, 5, 5, 5, 5, 76,
        0, 5, 5, 103, 5, 5, 0,
        76, 5, 5, 5, 5, 5, 76,
        0, 76, 5, 5, 5, 76, 0,
        0, 0, 76, 0, 76, 0, 0
      ]
    }
  ]
}