{
  "width": 11,
  "height": 7,
  "tileSize": 16,
  "layers": [
    {
      "name": "merchant_stalls",
      "data": [
        0, 0, 0, 0, 0, 0, 0, 0, 0, 0, 0,
        0, 54, 54, 0, 0, 0, 0, 54, 54, 0, 0,
        0, 68, 68, 0, 0, 0, 0, 68, 68, 0, 0,
        0, 0, 0, 0, 0, 0, 0, 0, 0, 0, 0,
        0, 54, 54, 0, 0, 0, 0, 54, 54, 0, 0,
        0, 68, 68, 0, 0, 0, 0, 68, 68, 0, 0,
        0, 0, 0, 0, 0, 0, 0, 0, 0, 0, 0
      ]
    }
  ]
}