{
  "width": 7,
  "height": 9,
  "tileSize": 16,
  "layers": [
    {
      "name": "mountain_pass",
      "data": [
        78, 78, 78, 78, 78, 78, 78,
        78, 78, 78, 78, 78, 78, 78,
        78, 78, 78, 83, 78, 78, 78,
        78, 78, 78, 83, 78, 78, 78,
        78, 78, 12, 83, 12, 78, 78,
        78, 12, 12, 83, 12, 12, 78,
        78, 12, 12, 83, 12, 12, 78,
        12, 12, 12, 83, 12, 12, 12,
        12, 12, 12, 83, 12, 12, 12
      ]
    }
  ]
}