{
  "width": 9,
  "height": 7,
  "tileSize": 16,
  "layers": [
    {
      "name": "riverside",
      "data": [
        8, 8, 8, 8, 8, 8, 8, 8, 8,
        8, 8, 8, 8, 8, 8, 8, 8, 8,
        25, 26, 26, 26, 26, 26, 26, 26, 27,
        33, 13, 13, 13, 13, 13, 13, 13, 35,
        33, 13, 13, 87, 87, 87, 13, 13, 35,
        33, 13, 13, 13, 13, 13, 13, 13, 35,
        41, 42, 42, 42, 42, 42, 42, 42, 43
      ]
    }
  ]
}