{
  "width": 11,
  "height": 9,
  "tileSize": 16,
  "layers": [
    {
      "name": "shop_interior",
      "data": [
        25, 26, 26, 26, 26, 26, 26, 26, 26, 26, 27,
        33, 5, 5, 5, 5, 5, 5, 5, 5, 5, 35,
        33, 5, 36, 0, 0, 0, 0, 0, 36, 5, 35,
        33, 5, 0, 0, 0, 0, 0, 0, 0, 5, 35,
        33, 5, 0, 0, 0, 0, 0, 0, 0, 5, 35,
        33, 5, 0, 0, 0, 68, 0, 0, 0, 5, 35,
        33, 5, 0, 0, 68, 68, 68, 0, 0, 5, 35,
        33, 5, 5, 5, 5, 53, 5, 5, 5, 5, 35,
        41, 42, 42, 42, 42, 42, 42, 42, 42, 42, 43
      ]
    }
  ]
}