{
  "width": 11,
  "height": 9,
  "tileSize": 16,
  "layers": [
    {
      "name": "shop_market",
      "data": [
        12, 12, 12, 12, 12, 12, 12, 12, 12, 12, 12,
        12, 74, 12, 75, 12, 12, 12, 74, 12, 75, 12,
        12, 12, 12, 12, 12, 81, 12, 12, 12, 12, 12,
        12, 54, 54, 12, 12, 12, 12, 54, 54, 12, 12,
        12, 68, 68, 12, 12, 84, 12, 68, 68, 12, 12,
        12, 12, 12, 12, 12, 12, 12, 12, 12, 12, 12,
        12, 36, 12, 12, 84, 12, 12, 12, 36, 12, 12,
        12, 12, 12, 12, 12, 12, 12, 12, 12, 12, 12,
        82, 82, 82, 82, 82, 82, 82, 82, 82, 82, 82
      ]
    }
  ]
}