{
  "width": 8,
  "height": 6,
  "tileSize": 16,
  "layers": [
    {
      "name": "small_lake",
      "data": [
        8, 8, 8, 8, 8, 8, 8, 8,
        8, 25, 26, 26, 26, 27, 8, 8,
        8, 33, 13, 13, 13, 35, 8, 8,
        8, 33, 13, 13, 13, 35, 8, 8,
        8, 41, 42, 42, 42, 43, 8, 8,
        8, 8, 8, 8, 8, 8, 8, 8
      ]
    }
  ]
}