{
  "width": 9,
  "height": 7,
  "tileSize": 16,
  "layers": [
    {
      "name": "tavern",
      "data": [
        25, 26, 26, 26, 26, 26, 26, 26, 27,
        33, 45, 45, 45, 45, 45, 45, 45, 35,
        33, 45, 68, 0, 68, 0, 68, 45, 35,
        33, 45, 0, 0, 0, 0, 0, 45, 35,
        33, 45, 68, 0, 68, 0, 68, 45, 35,
        33, 45, 45, 45, 53, 45, 45, 45, 35,
        41, 42, 42, 42, 42, 42, 42, 42, 43
      ]
    }
  ]
}