{
  "width": 11,
  "height": 9,
  "tileSize": 16,
  "layers": [
    {
      "name": "town_square",
      "data": [
        82, 82, 82, 82, 82, 82, 82, 82, 82, 82, 82,
        82, 12, 12, 12, 12, 83, 12, 12, 12, 12, 82,
        82, 12, 12, 12, 12, 83, 12, 12, 12, 12, 82,
        82, 12, 12, 48, 12, 83, 12, 48, 12, 12, 82,
        82, 12, 12, 12, 12, 12, 12, 12, 12, 12, 82,
        82, 83, 83, 83, 12, 12, 12, 83, 83, 83, 82,
        82, 12, 12, 12, 12, 83, 12, 12, 12, 12, 82,
        82, 12, 12, 12, 12, 83, 12, 12, 12, 12, 82,
        82, 82, 82, 82, 82, 82, 82, 82, 82, 82, 82
      ]
    }
  ]
}