{
  "width": 9,
  "height": 7,
  "tileSize": 16,
  "layers": [
    {
      "name": "town_gate",
      "data": [
        1, 1, 1, 1, 1, 1, 1, 1, 1,
        1, 1, 1, 1, 1, 1, 1, 1, 1,
        1, 1, 0, 0, 0, 0, 0, 1, 1,
        1, 1, 0, 0, 57, 0, 0, 1, 1,
        1, 1, 0, 0, 0, 0, 0, 1, 1,
        1, 1, 0, 0, 0, 0, 0, 1, 1,
        12, 12, 12, 12, 12, 12, 12, 12, 12
      ]
    }
  ]
}