{
  "width": 9,
  "height": 7,
  "tileSize": 16,
  "layers": [
    {
      "name": "training_grounds",
      "data": [
        81, 81, 81, 81, 81, 81, 81, 81, 81,
        81, 12, 12, 12, 12, 12, 12, 12, 81,
        81, 12, 38, 0, 38, 0, 38, 12, 81,
        81, 12, 0, 48, 0, 48, 0, 12, 81,
        81, 12, 38, 0, 38, 0, 38, 12, 81,
        81, 12, 12, 12, 12, 12, 12, 12, 81,
        81, 81, 81, 81, 83, 81, 81, 81, 81
      ]
    }
  ]
}