{
  "width": 7,
  "height": 7,
  "tileSize": 16,
  "layers": [
    {
      "name": "village_house",
      "data": [
        0, 0, 25, 26, 27, 0, 0,
        0, 25, 45, 45, 45, 27, 0,
        25, 45, 45, 45, 45, 45, 27,
        33, 45, 45, 45, 45, 45, 35,
        33, 45, 45, 53, 45, 45, 35,
        41, 42, 42, 42, 42, 42, 43,
        0, 0, 0, 82, 0, 0, 0
      ]
    }
  ]
}