{
  "width": 9,
  "height": 7,
  "tileSize": 16,
  "layers": [
    {
      "name": "well_square",
      "data": [
        12, 12, 12, 12, 12, 12, 12, 12, 12,
        12, 5, 5, 5, 5, 5, 5, 5, 12,
        12, 5, 5, 0, 0, 0, 5, 5, 12,
        12, 5, 0, 59, 59, 59, 0, 5, 12,
        12, 5, 5, 0, 0, 0, 5, 5, 12,
        12, 5, 5, 5, 5, 5, 5, 5, 12,
        12, 12, 12, 12, 12, 12, 12, 12, 12
      ]
    }
  ]
}