{
  "width": 7,
  "height": 9,
  "tileSize": 16,
  "layers": [
    {
      "name": "wizard_tower",
      "data": [
        0, 0, 49, 0, 49, 0, 0,
        0, 25, 26, 26, 26, 27, 0,
        0, 33, 45, 45, 45, 35, 0,
        0, 33, 45, 103, 45, 35, 0,
        0, 33, 45, 45, 45, 35, 0,
        0, 33, 45, 53, 45, 35, 0,
        0, 33, 45, 45, 45, 35, 0,
        0, 41, 42, 42, 42, 43, 0,
        0, 0, 0, 82, 0, 0, 0
      ]
    }
  ]
}