{
  "width": 13,
  "height": 7,
  "tileSize": 16,
  "data": {
    "ground": [
      25, 26, 26, 26, 26, 26, 26, 26, 26, 26, 26, 26, 27,
      33, 2, 2, 2, 2, 2, 2, 2, 2, 2, 2, 2, 35,
      33, 2, 2, 2, 2, 2, 2, 2, 2, 2, 2, 2, 35,
      33, 2, 2, 2, 2, 2, 2, 2, 2, 2, 2, 2, 35,
      33, 2, 2, 2, 2, 2, 2, 2, 2, 2, 2, 2, 35,
      33, 2, 2, 2, 2, 2, 2, 2, 2, 2, 2, 2, 35,
      41, 42, 42, 42, 42, 42, 42, 42, 42, 42, 42, 42, 43
    ],
    "decorations": [
      0, 0, 0, 0, 0, 0, 0, 0, 0, 0, 0, 0, 0,
      0, 0, 0, 0, 0, 103, 0, 0, 104, 0, 0, 74, 0,
      0, 0, 0, 0, 0, 0, 0, 0, 0, 0, 0, 0, 0,
      0, 0, 0, 0, 0, 0, 0, 0, 0, 0, 0, 0, 0,
      0, 0, 0, 0, 0, 0, 0, 39, 0, 0, 0, 0, 0,
      0, 0, 0, 0, 0, 36, 0, 0, 0, 0, 36, 0, 0,
      0, 0, 0, 0, 0, 0, 0, 0, 0, 0, 0, 0, 0
    ]
  }
}