{
  "width": 17,
  "height": 7,
  "tileSize": 16,
  "data": {
    "ground": [
      25, 26, 26, 26, 26, 26, 26, 26, 26, 26, 26, 26, 26, 26, 26, 26, 27,
      33, 8, 8, 8, 8, 8, 8, 8, 8, 8, 8, 8, 8, 8, 8, 35,
      33, 8, 8, 8, 8, 8, 8, 8, 8, 8, 8, 8, 8, 8, 8, 35,
      33, 8, 8, 8, 8, 8, 8, 8, 8, 8, 8, 8, 8, 8, 8, 35,
      33, 8, 8, 8, 8, 8, 8, 8, 8, 8, 8, 8, 8, 8, 8, 35,
      33, 8, 8, 8, 8, 8, 8, 8, 8, 8, 8, 8, 8, 8, 8, 35,
      41, 42, 42, 42, 42, 42, 42, 42, 42, 42, 42, 42, 42, 42, 42, 42, 43
    ],
    "decorations": [
      0, 0, 0, 0, 0, 0, 0, 0, 0, 0, 0, 0, 0, 0, 0, 0, 0,
      0, 47, 0, 0, 47, 0, 0, 47, 0, 0, 47, 0, 0, 47, 0, 0,
      0, 0, 0, 0, 0, 0, 0, 0, 0, 0, 0, 0, 0, 0, 0, 0, 0,
      0, 0, 46, 0, 0, 46, 0, 0, 46, 0, 0, 46, 0, 0, 0, 0, 0,
      0, 0, 0, 0, 0, 0, 0, 0, 0, 0, 0, 0, 0, 0, 0, 0, 0,
      0, 81, 0, 0, 0, 0, 0, 0, 0, 0, 0, 0, 0, 0, 0, 81, 0,
      0, 0, 0, 0, 0, 0, 0, 0, 0, 0, 0, 0, 0, 0, 0, 0, 0
    ]
  }
}