{
  "width": 20,
  "height": 7,
  "tileSize": 16,
  "data": {
    "ground": [
      25, 26, 26, 26, 26, 26, 26, 26, 26, 26, 26, 26, 26, 26, 26, 26, 26, 26, 26, 27,
      33, 12, 12, 12, 12, 12, 12, 12, 12, 12, 12, 12, 12, 12, 12, 12, 12, 12, 12, 35,
      33, 12, 12, 12, 12, 12, 12, 12, 12, 12, 12, 12, 12, 12, 12, 12, 12, 12, 12, 35,
      33, 12, 12, 12, 12, 12, 12, 12, 12, 12, 12, 12, 12, 12, 12, 12, 12, 12, 12, 35,
      41, 42, 42, 42, 42, 42, 34, 12, 12, 12, 12, 12, 12, 12, 12, 12, 12, 12, 12, 35,
      0, 0, 0, 0, 0, 0, 33, 12, 12, 12, 12, 12, 12, 12, 12, 12, 12, 12, 12, 35,
      0, 0, 0, 0, 0, 0, 41, 42, 42, 42, 42, 42, 42, 42, 42, 42, 34, 12, 12, 35
    ],
    "decorations": [
      0, 0, 0, 0, 0, 0, 0, 0, 0, 0, 0, 0, 0, 0, 0, 0, 0, 0, 0, 0,
      0, 74, 0, 0, 75, 0, 0, 84, 0, 0, 0, 0, 49, 0, 0, 0, 0, 45, 0, 0,
      0, 0, 0, 0, 0, 0, 0, 0, 0, 0, 0, 0, 0, 0, 0, 0, 0, 53, 0, 0,
      0, 0, 0, 37, 0, 0, 0, 0, 0, 38, 0, 0, 0, 0, 0, 0, 0, 0, 0, 0,
      0, 0, 0, 0, 0, 0, 0, 0, 0, 0, 0, 0, 0, 0, 0, 0, 0, 0, 0, 0,
      0, 0, 0, 0, 0, 0, 0, 0, 0, 0, 0, 0, 0, 0, 0, 0, 0, 0, 0, 0,
      0, 0, 0, 0, 0, 0, 0, 0, 0, 0, 0, 0, 0, 0, 0, 0, 0, 82, 82, 0
    ]
  }
}